11111111111111
100000P00000C1
10111011101101
10C00100010001
11101110111011
1E000100010001
101111C0111101
10000000000001
10111011101101
1010001000C001
10101110111001
10C00100010101
11111111111111
