11111111
1000E001
10C00001
1000P001
11111111
