1111111
1E00001
1000001
10C0001
10000P1
1111111
